11111
101E1
1C111
1P001
10001
11111