111111
100001
10001
10001
100001
111111