111111
100001
1000011
100001
100001
111111