11111111
1P000001
1101E001
1C100001
11000001
11111111
