111111111111
100P01010001
100000000001
100100000111
10E0CCC000C1
111111111111