11111111
100P0101
10000011
10100001
1E0000C1
11111111
