111111111111
100P01010001
100000C00001
101000000001
1E0000000001
111111111110
