111111111111
1P0001010001
100000000001
100100000111
100E000000C1
111111111111