11111111
10000101
1P01E011
10100001
100000C1
11111111
