111111
1P0001
1001E1
1C1001
111111
