111111111111
100P01010001
100000110001
101000010011
1E000000C0C1
111111111111
