11111
10101
1C111
1P001
10001
11111