11111
101E1
1C101
10001
10001
11111