11111
101E1
10101
1P001
10001
11111