11111
1C1E1
1C1B1
1PCC1
1CCC1
11111